
Stage 1
#####
#OoP#
#####
=====
Stage 2
  #######
###  O  ###
#    o    #
# Oo P oO #
###  o  ###
 #   O  # 
 ########
=====
Stage 3
   #########
###  O o   ###
#  o     o  O#
# O   P    oO#
###        ###
  #   O  o # 
  ##########
 =====
 Stage 4
   ##########
###  O o    ###
#  o     o   O#
# O   P     oO#
#   O   o     #
###         ###
  #   O  o  # 
  ###########
=====
Stage 5
      ####
  ####    ####
###  O o  O  ###
#              #
##  o     o   O#
# O   P      oO#
#       o      #
### o      #####
  #   O  o   # 
  ####  O ####
      ####
=====